27
14
##########################
##.@############.........#
#..........#####.........#
#.0#####0#.#####.........#
#..#...#.0.#####....<....#
#.0.0....0######.........#
#.0..0..#..#####.........#
#.####0.##.#####.........#
#..0...0.#.#####.........#
#.###0#...0.############.#
#...#..0#.0.^^^^^^^^^^^^.#
#..0......################
#####..#..################
##########################