15
13
##############
#....####...##
#.0..####.0.##
#.0......0..##
#..###@###0.##
##########.###
#..^^^<#.....#
#..#####0....#
##^#####.0...#
##^#####.0...#
##..^^^^0.0..#
##..##########
##############