27
18
##########################
#@......^^^^^^^^^^^^^^^^.#
#.......################.#
#######.################.#
##...........###########.#
##.0.0.0.0.0.###########.#
########.###############.#
#...0.0..0.0.###########.#
#...0........###########.#
#####.##################.#
##..0.0.0...######.....#.#
##.....0....####.......#.#
##.0.0...0.#######.....#.#
#######.########....<..+.#
#..0.....#########.....###
#........#######.......###
#...##############.....###
##########################